word	part of speech	description
zorblix	noun	a small, iridescent creature that lives in clouds
flimmering	adjective	describing light that appears to dance and shimmer
quixolate	verb	to embark on an idealistic but impractical quest
neoplexy	noun	the state of being overwhelmed by new information or technology
vorpal	adjective	impossibly sharp or deadly
glimmerwit	noun	a sudden flash of inspiration or insight
chromashift	verb	to gradually change color in response to stimuli
nebulox	noun	a dream-like state induced by certain types of music
phantangle	verb	to become entangled in an illusory or imaginary problem
lumidance	noun	a graceful display of light, often seen in bioluminescent organisms
fractalize	verb	to divide or multiply into increasingly complex patterns
whimsicron	noun	a unit of measurement for whimsical or fanciful ideas
zenithize	verb	to reach the highest point of achievement or development
chrysomorph	noun	an object that can change its shape and color at will
echoling	adjective	describing sounds that seem to linger and repeat softly
zymblox	noun	a device that converts ambient sound into edible cubes
frazzlent	adjective	describing the sensation of being both energized and exhausted
quorpulate	verb	to communicate solely through interpretive dance moves
neffibril	noun	microscopic fibers that connect parallel universes
vexolith	adjective	pertaining to rocks that cause confusion when touched
glimmerob	noun	a blob of light that follows people on foggy nights
chrondulate	verb	to manipulate time in small, localized areas
nebulark	noun	a vehicle designed for travel through gaseous nebulae
phantorque	verb	to apply imaginary force to dream objects
lumifract	noun	a shard of solidified light
zorphicate	verb	to travel instantaneously by folding space
whimscalibur	noun	a legendary weapon that becomes more powerful the sillier it looks
zenithorp	verb	to ascend beyond normal physical limitations
chrysoplex	noun	a structure that changes its architecture based on the user's mood
echoplasm	adjective	describing substances that replicate nearby sounds
blixnor	noun	a pocket-sized device that translates animal thoughts into human language
frazzulent	adjective	describing the texture of fabric woven from moonbeams
quorpify	verb	to transform abstract concepts into tangible, interactive holograms
neffibulate	noun	the act of solving complex equations while sleepwalking
vexolume	adjective	pertaining to books that change their content based on the reader's mood
glimmersect	noun	a species of insect that communicates through bioluminescent patterns
chrondulate	verb	to experience multiple timelines simultaneously
nebulight	noun	a form of illumination powered by harvested stardust
phantorque	verb	to manipulate the physical properties of objects in dreams
lumifract	noun	a crystal that stores and releases memories in the form of light
zorphicate	verb	to travel between dimensions by folding origami
whimsicron	noun	a subatomic particle responsible for generating random acts of kindness
zenithorp	verb	to achieve a state of perfect balance between chaos and order
chrysoplex	noun	a material that adapts its molecular structure to mimic any surface it touches
echoling	adjective	describing words that create physical ripples in the air when spoken
